90;90;90;90;90;90;90;90;90;90;90;90;90;90;90;90;90;90;90;90;90;90;90;90;90;90;90;90;90;90;90;90;90;90;90;90;90;90;90;90;90;90;90;90;90;90;90;90;90;90;90;90;90;90;90;90;90;90;90;90;90;90;90;90
90;90;90;90;90;90;90;90;90;90;90;90;90;90;90;90;90;90;90;90;90;90;90;90;90;90;90;90;90;90;90;90;90;90;90;90;90;90;90;90;90;90;90;90;90;90;90;90;90;90;90;90;90;90;90;90;90;90;90;90;90;90;90;90
90;90;90;90;90;90;90;90;90;90;90;90;90;90;90;90;90;90;90;90;90;90;90;90;90;90;90;90;90;90;90;90;90;90;90;90;90;90;90;90;90;90;90;90;90;90;90;90;90;90;90;90;90;90;90;90;90;90;90;90;90;90;90;90
90;90;90;90;90;90;90;90;90;90;90;90;90;90;90;90;90;90;90;90;90;90;90;90;90;90;90;90;90;90;90;90;90;90;90;90;90;90;90;90;90;90;90;90;90;90;90;90;90;90;90;90;90;90;90;90;90;90;90;90;90;90;90;90
90;90;90;90;90;90;90;90;90;90;90;90;90;90;90;90;90;90;90;90;90;90;90;90;90;90;90;90;90;90;90;90;90;90;90;90;90;90;90;90;90;90;90;90;90;90;90;90;90;90;90;90;90;90;90;90;90;90;90;90;90;90;90;90
90;90;90;90;90;90;90;90;90;90;90;90;90;90;90;90;90;90;90;90;90;90;90;90;90;90;90;90;90;90;90;90;90;90;90;90;90;90;90;90;90;90;90;90;90;90;90;90;90;90;90;90;90;90;90;90;90;90;90;90;90;90;90;90
90;90;90;90;90;90;90;90;90;90;90;90;90;90;90;90;90;90;90;90;90;90;90;90;90;90;90;90;90;90;90;90;90;90;90;90;90;90;90;90;90;90;90;90;90;90;90;90;90;90;90;90;90;90;90;90;90;90;90;90;90;90;90;90
90;90;90;90;90;90;90;90;90;90;90;90;90;90;90;90;90;90;90;90;90;90;90;90;90;90;90;90;90;90;90;90;90;90;90;90;90;90;90;90;90;90;90;90;90;90;90;90;90;90;90;90;90;90;90;90;90;90;90;90;90;90;90;90
91;91;91;91;91;91;91;91;91;91;91;91;91;91;91;90;90;90;90;90;90;90;90;90;90;90;90;90;90;90;90;90;90;90;90;90;90;90;90;90;90;90;90;90;90;90;91;91;91;91;91;91;91;91;91;91;91;91;91;91;91;91;91;91
91;91;91;91;91;91;91;91;91;91;91;91;91;91;91;91;90;90;90;90;90;90;90;90;90;90;90;90;90;90;90;90;90;90;90;90;90;90;90;90;90;90;90;90;90;91;91;91;91;91;91;91;91;91;91;91;91;91;91;91;91;91;91;91
91;91;91;91;91;91;91;91;91;91;91;91;91;91;91;91;91;90;90;90;90;90;91;91;91;91;91;91;90;90;90;90;90;90;90;90;90;90;90;90;90;90;90;90;91;91;91;91;91;91;91;91;91;91;91;91;91;91;91;91;91;91;91;91
91;91;91;91;91;91;91;91;91;91;91;91;91;91;91;91;91;91;91;91;91;91;91;91;91;91;91;91;91;91;90;90;90;90;90;90;90;90;90;90;90;90;90;91;91;91;91;91;91;91;91;91;91;91;91;91;91;91;91;91;91;91;91;91
91;91;91;91;91;91;91;91;91;91;91;91;91;91;91;91;91;91;91;91;91;91;91;91;91;91;91;91;91;91;91;91;90;90;90;90;90;90;90;90;90;90;91;91;91;91;91;91;91;91;91;91;91;91;91;91;91;91;91;91;91;91;91;91
91;91;91;91;91;91;91;91;91;91;91;91;91;91;91;91;91;91;91;91;91;91;91;91;91;91;91;91;91;91;91;91;91;91;91;91;91;90;90;90;90;91;91;91;91;91;91;91;91;91;91;91;91;91;91;91;91;91;91;91;91;91;91;91
91;91;91;91;91;91;91;91;91;91;91;91;91;91;91;91;91;91;91;91;91;91;91;91;91;91;91;91;91;91;91;91;91;91;91;91;91;91;91;91;91;91;91;91;91;91;91;91;91;91;91;91;91;91;91;91;91;91;91;91;91;91;91;91
91;91;91;91;91;91;91;91;91;91;91;91;91;91;91;91;91;91;91;91;91;91;91;91;91;91;91;91;91;91;91;91;91;91;91;91;91;91;91;91;91;91;91;91;91;91;91;91;91;91;91;91;91;91;91;91;91;91;91;91;91;91;91;91
92;92;92;92;92;92;92;92;92;92;92;92;91;91;91;91;91;91;91;91;91;91;91;91;91;91;91;91;91;91;91;91;91;91;91;91;91;91;91;91;91;91;91;91;91;91;91;91;91;91;91;91;91;91;91;91;91;91;91;91;91;91;91;91
92;92;92;92;92;92;92;92;92;92;92;92;92;92;92;91;91;91;92;92;92;92;92;92;92;92;92;91;91;91;91;91;91;91;91;91;91;91;91;91;91;91;91;91;91;91;91;91;91;91;91;91;91;91;91;91;91;91;91;91;91;91;91;91
92;92;92;92;92;92;92;92;92;92;92;92;92;92;92;92;92;92;92;92;92;92;92;92;92;92;92;92;92;92;91;91;91;91;91;91;91;91;91;91;91;91;91;91;91;91;91;91;91;91;91;91;91;91;91;91;91;91;91;91;91;91;91;91
91;91;91;91;91;91;91;91;91;91;91;91;92;92;92;92;92;92;92;92;92;92;92;92;92;92;92;92;92;92;92;92;92;91;91;91;91;91;91;91;91;91;91;91;91;91;91;91;91;91;91;91;91;91;91;91;91;91;91;91;91;92;92;92
91;91;91;91;91;91;91;91;91;91;91;91;91;91;91;92;92;92;91;91;91;91;91;91;91;91;91;92;92;92;92;92;92;92;92;92;92;92;92;92;92;92;92;92;92;92;92;92;92;92;92;92;92;92;92;92;92;92;92;92;92;92;92;92
91;91;91;91;91;91;91;91;91;91;91;91;91;91;91;91;91;91;91;91;91;91;91;91;91;91;91;91;91;91;92;92;92;92;92;92;92;92;92;92;92;92;92;92;92;92;92;92;92;92;92;92;92;92;92;92;92;92;92;92;92;92;92;92
91;91;91;91;91;91;91;91;91;91;91;91;91;91;91;91;91;91;91;91;91;91;91;91;91;91;91;91;91;91;91;91;91;92;92;92;92;92;92;92;92;92;92;92;92;92;92;92;92;92;92;92;92;92;92;92;92;92;92;92;92;92;91;91
91;91;91;91;91;91;91;91;91;91;91;91;91;91;91;91;91;91;91;91;91;91;91;91;91;91;91;91;91;91;91;91;91;91;91;91;91;91;91;91;91;91;91;91;91;91;91;91;91;91;91;91;91;91;91;91;91;91;91;91;91;91;91;91
91;91;91;91;91;91;91;91;91;91;91;91;91;91;91;91;91;91;91;91;91;91;91;91;91;91;91;91;91;91;91;91;91;91;91;91;91;91;91;91;91;91;91;91;91;91;91;91;91;91;91;91;91;91;91;91;91;91;91;91;91;91;91;91
91;91;91;91;91;91;91;91;91;91;91;91;91;91;91;91;91;91;91;91;91;91;91;91;91;91;91;91;91;91;91;91;91;91;91;91;91;91;91;91;91;91;91;91;91;91;91;91;91;91;91;91;91;91;91;91;91;91;91;91;91;91;91;91
91;91;91;91;91;91;91;91;91;91;91;91;91;91;91;91;91;91;91;91;91;91;91;91;91;91;91;91;91;91;91;91;91;91;91;91;91;91;91;91;91;91;91;91;91;91;91;91;91;91;91;91;91;91;91;91;91;91;91;91;91;91;91;91
91;91;91;91;91;91;91;91;91;91;91;91;91;91;91;91;91;91;91;91;91;91;91;91;91;91;91;91;91;91;91;91;91;91;91;91;91;91;91;91;91;91;91;91;91;91;91;91;91;91;91;91;91;91;91;91;91;91;91;91;91;91;91;91
91;91;91;91;91;91;91;91;91;91;91;91;91;91;91;91;91;91;91;91;91;91;91;91;91;91;91;91;91;91;91;91;91;91;91;91;91;91;91;91;91;91;91;91;91;91;91;91;91;91;91;91;91;91;91;91;91;91;91;91;91;91;91;91
90;90;90;90;90;90;90;90;90;90;90;90;90;91;91;91;91;91;91;91;91;91;91;91;91;91;91;91;91;91;91;91;91;91;91;91;91;91;91;91;91;91;91;91;91;91;91;91;91;91;91;91;91;91;91;91;91;91;91;91;91;91;91;91
90;90;90;90;90;90;90;90;90;90;90;90;90;91;91;91;91;91;91;91;91;91;91;91;91;91;91;91;91;91;91;91;91;91;91;91;91;91;91;91;91;91;91;91;91;91;91;91;91;91;91;91;91;91;91;91;91;91;91;91;91;91;91;90
90;90;90;90;90;90;90;90;90;90;90;90;90;90;91;91;91;91;91;91;91;91;91;91;91;91;91;91;91;91;91;91;91;91;91;91;91;91;91;91;91;91;91;91;91;91;91;91;91;91;91;91;91;91;91;91;91;91;91;91;91;91;90;90
90;90;90;90;90;90;90;90;90;90;90;90;90;90;90;91;91;91;91;91;91;91;91;91;91;91;91;91;91;91;91;91;91;91;91;91;91;91;91;91;91;91;91;91;91;91;91;91;91;91;91;91;91;91;91;91;91;91;91;91;91;90;90;90
90;90;90;90;90;90;90;90;90;90;90;90;90;90;90;90;91;91;91;91;91;91;91;91;91;91;91;91;91;91;91;91;91;91;91;91;91;91;91;91;91;91;91;91;91;91;91;91;91;91;91;91;91;91;91;91;91;91;91;91;90;90;90;90
90;90;90;90;90;90;90;90;90;90;90;90;90;90;90;90;90;91;91;91;91;91;91;91;91;91;91;91;91;91;91;91;91;91;91;91;91;91;91;91;91;91;91;91;91;91;91;91;91;91;91;91;91;91;91;91;91;91;91;90;90;90;90;90
90;90;90;90;90;90;90;90;90;90;90;90;90;90;90;90;90;90;91;91;91;91;91;91;91;91;91;91;91;91;91;91;91;91;91;91;91;91;91;91;91;91;91;91;91;91;91;91;91;90;90;90;90;90;90;90;90;90;90;90;90;90;90;90
90;90;90;90;90;90;90;90;90;90;90;90;90;90;90;90;90;90;90;90;90;90;90;90;90;90;90;90;90;90;90;90;90;90;90;90;90;91;91;91;91;91;91;91;91;91;91;91;90;90;90;90;90;90;90;90;90;90;90;90;90;90;90;90
90;90;90;90;90;90;90;90;90;90;90;90;90;90;90;90;90;90;90;90;90;90;90;90;90;90;90;90;90;90;90;90;90;90;90;90;90;90;90;91;91;91;91;91;91;91;91;90;90;90;90;90;90;90;90;90;90;90;90;90;90;90;90;90
90;90;90;90;90;90;90;90;90;90;90;90;90;90;90;90;90;90;90;90;90;90;90;90;90;90;90;90;90;90;90;90;90;90;90;90;90;90;90;90;91;91;91;91;91;91;90;90;90;90;90;90;90;90;90;90;90;90;90;90;90;90;90;90
90;90;90;90;90;90;90;90;90;90;90;90;90;90;90;90;90;90;90;90;90;90;90;90;90;90;90;90;90;90;90;90;90;90;90;90;90;90;90;90;90;90;90;90;90;90;90;90;90;90;90;90;90;90;90;90;90;90;90;90;90;90;90;90
90;90;90;90;90;90;90;90;90;90;90;90;90;90;90;90;90;90;90;90;90;90;90;90;90;90;90;90;90;90;90;90;90;90;90;90;90;90;90;90;90;90;90;90;90;90;90;90;90;90;90;90;90;90;90;90;90;90;90;90;90;90;90;90
90;90;90;90;90;90;90;90;90;90;90;90;90;90;90;90;90;90;90;90;90;90;90;90;90;90;90;90;90;90;90;90;90;90;90;90;90;90;90;90;90;90;90;90;90;90;90;90;90;90;90;90;90;90;90;90;90;90;90;90;90;90;90;90
90;90;90;90;90;90;90;90;90;90;90;90;90;90;90;90;90;90;90;90;90;90;90;90;90;90;90;90;90;90;90;90;90;90;90;90;90;90;90;90;90;90;90;90;90;90;90;90;90;90;90;90;90;90;90;90;90;90;90;90;90;90;90;90
90;90;90;90;90;90;90;90;90;90;90;90;90;90;90;90;90;90;90;90;90;90;90;90;90;90;90;90;90;90;90;90;90;90;90;90;90;90;90;90;90;90;90;90;90;90;90;90;90;90;90;90;90;90;90;90;90;90;90;90;90;90;90;90
90;90;90;90;90;90;90;90;90;90;90;90;90;90;90;90;90;90;90;90;90;90;90;90;90;90;90;90;90;90;90;90;90;90;90;90;90;90;90;90;90;90;90;90;90;90;90;90;90;90;90;90;90;90;90;90;90;90;90;90;90;90;90;90
90;90;90;90;90;90;90;90;90;90;90;90;90;90;90;90;90;90;90;90;90;90;90;90;90;90;90;90;90;90;90;90;90;90;90;90;90;90;90;90;90;90;90;90;90;90;90;90;90;90;90;90;90;90;90;90;90;90;90;90;90;90;90;90
90;90;90;90;90;90;90;90;90;90;90;90;90;90;90;90;90;90;90;90;90;90;90;90;90;90;90;90;90;90;90;90;90;90;90;90;90;90;90;90;90;90;90;90;90;90;90;90;90;90;90;90;90;90;90;90;90;90;90;90;90;90;90;90
90;90;90;90;90;90;90;90;90;90;90;90;90;90;90;90;90;90;90;90;90;90;90;90;90;90;90;90;90;90;90;90;90;90;90;90;90;90;90;90;90;90;90;90;90;90;90;90;90;90;90;90;90;90;90;90;90;90;90;90;90;90;90;90
90;90;90;90;90;90;90;90;90;90;90;90;90;90;90;90;90;90;90;90;90;90;90;90;90;90;90;90;90;90;90;90;90;90;90;90;90;90;90;90;90;90;90;90;90;90;90;90;90;90;90;90;90;90;90;90;90;90;90;90;90;90;90;90
90;90;90;90;90;90;90;90;90;90;90;90;90;90;90;90;90;90;90;90;90;90;90;90;90;90;90;90;90;90;90;90;90;90;90;90;90;90;90;90;90;90;90;90;90;90;90;90;90;90;90;90;90;90;90;90;90;90;90;90;90;90;90;90
90;90;90;90;90;90;90;90;90;90;90;90;90;90;90;90;90;90;90;90;90;90;90;90;90;90;90;90;90;90;90;90;90;90;90;90;90;90;90;90;90;90;90;90;90;90;90;90;90;90;90;90;90;90;90;90;90;90;90;90;90;90;90;90
90;90;90;90;90;90;90;90;90;90;90;90;90;90;90;90;90;90;90;90;90;90;90;90;90;90;90;90;90;90;90;90;90;90;90;90;90;90;90;90;90;90;90;90;90;90;90;90;90;90;90;90;90;90;90;90;90;90;90;90;90;90;90;90
90;90;90;90;90;90;90;90;90;90;90;90;90;90;90;90;90;90;90;90;90;90;90;90;90;90;90;90;90;90;90;90;90;90;90;90;90;90;90;90;90;90;90;90;90;90;90;90;90;90;90;90;90;90;90;90;90;90;90;90;90;90;90;90
90;90;90;90;90;90;90;90;90;90;90;90;90;90;90;90;90;90;90;90;90;90;90;90;90;90;90;90;90;90;90;90;90;90;90;90;90;90;90;90;90;90;90;90;90;90;90;90;90;90;90;90;90;90;90;90;90;90;90;90;90;90;90;90
90;90;90;90;90;90;90;90;90;90;90;90;90;90;90;90;90;90;90;90;90;90;90;90;90;90;90;90;90;90;90;90;90;90;90;90;90;90;90;90;90;90;90;90;90;90;90;90;90;90;90;90;90;90;90;90;90;90;90;90;90;90;90;90
90;90;90;90;90;90;90;90;90;90;90;90;90;90;90;90;90;90;90;90;90;90;90;90;90;90;90;90;90;90;90;90;90;90;90;90;90;90;90;90;90;90;90;90;90;90;90;90;90;90;90;90;90;90;90;90;90;90;90;90;90;90;90;90
90;90;90;90;90;90;90;90;90;90;90;90;90;90;90;90;90;90;90;90;90;90;90;90;90;90;90;90;90;90;90;90;90;90;90;90;90;90;90;90;90;90;90;90;90;90;90;90;90;90;90;90;90;90;90;90;90;90;90;90;90;90;90;90
90;90;90;90;90;90;90;90;90;90;90;90;90;90;90;90;90;90;90;90;90;90;90;90;90;90;90;90;90;90;90;90;90;90;90;90;90;90;90;90;90;90;90;90;90;90;90;90;90;90;90;90;90;90;90;90;90;90;90;90;90;90;90;90
90;90;90;90;90;90;90;90;90;90;90;90;90;90;90;90;90;90;90;90;90;90;90;90;90;90;90;90;90;90;90;90;90;90;90;90;90;90;90;90;90;90;90;90;90;90;90;90;90;90;90;90;90;90;90;90;90;90;90;90;90;90;90;90
90;90;90;90;90;90;90;90;90;90;90;90;90;90;90;90;90;90;90;90;90;90;90;90;90;90;90;90;90;90;90;90;90;90;90;90;90;90;90;90;90;90;90;90;90;90;90;90;90;90;90;90;90;90;90;90;90;90;90;90;90;90;90;90
90;90;90;90;90;90;90;90;90;90;90;90;90;90;90;90;90;90;90;90;90;90;90;90;90;90;90;90;90;90;90;90;90;90;90;90;90;90;90;90;90;90;90;90;90;90;90;90;90;90;90;90;90;90;90;90;90;90;90;90;90;90;90;90
90;90;90;90;90;90;90;90;90;90;90;90;90;90;90;90;90;90;90;90;90;90;90;90;90;90;90;90;90;90;90;90;90;90;90;90;90;90;90;90;90;90;90;90;90;90;90;90;90;90;90;90;90;90;90;90;90;90;90;90;90;90;90;90
90;90;90;90;90;90;90;90;90;90;90;90;90;90;90;90;90;90;90;90;90;90;90;90;90;90;90;90;90;90;90;90;90;90;90;90;90;90;90;90;90;90;90;90;90;90;90;90;90;90;90;90;90;90;90;90;90;90;90;90;90;90;90;90
90;90;90;90;90;90;90;90;90;90;90;90;90;90;90;90;90;90;90;90;90;90;90;90;90;90;90;90;90;90;90;90;90;90;90;90;90;90;90;90;90;90;90;90;90;90;90;90;90;90;90;90;90;90;90;90;90;90;90;90;90;90;90;90